"STATE/UT","CRIME HEAD","Persons in custody or on bail during the stage of investigation at the beginning of the year","Persons arrested during the year","Persons released or freed by Police or Magistrate before trial for want of evidence or any other reason","Persons in custody or on bail during the stage of investigation at the end of the year","Persons in whose cases charge sheets were laid during the year","Persons under trial at the beginning of the year","Total number of persons under trial during the year","Persons against whom cases were compounded or withdrawn","Persons in custody or on bail during the stage of trial at the end of the year","Persons in whose cases trials were completed during the year","Persons convicted","Persons acquitted"
"ANDHRA PRADESH","RAPE (SECTION 376 IPC)",783,1664,0,839,1608,3550,5158,17,3730,1411,178,1233
"ARUNACHAL PRADESH","RAPE (SECTION 376 IPC)",26,47,3,46,24,612,636,1,605,30,3,27
"ASSAM","RAPE (SECTION 376 IPC)",1668,1626,392,1746,1156,4642,5798,0,4840,958,153,805
"BIHAR","RAPE (SECTION 376 IPC)",1103,1327,94,938,1398,4642,6040,0,5095,945,161,784
"CHHATTISGARH","RAPE (SECTION 376 IPC)",93,1214,0,106,1201,5064,6265,0,5141,1124,259,865
"GOA","RAPE (SECTION 376 IPC)",28,61,2,52,35,153,188,1,170,17,1,16
"GUJARAT","RAPE (SECTION 376 IPC)",68,647,0,84,631,5057,5688,4,5369,315,56,259
"HARYANA","RAPE (SECTION 376 IPC)",99,940,0,42,997,1557,2554,0,1708,846,180,666
"HIMACHAL PRADESH","RAPE (SECTION 376 IPC)",46,259,8,57,240,743,983,2,831,150,41,109
"JAMMU & KASHMIR","RAPE (SECTION 376 IPC)",14,388,0,15,387,1588,1975,8,1592,375,28,347
"JHARKHAND","RAPE (SECTION 376 IPC)",363,780,0,437,706,1525,2231,11,1541,679,196,483
"KARNATAKA","RAPE (SECTION 376 IPC)",172,842,20,199,795,1927,2722,4,2075,643,97,546
"KERALA","RAPE (SECTION 376 IPC)",795,1259,3,865,1186,4805,5991,0,5694,297,62,235
"MADHYA PRADESH","RAPE (SECTION 376 IPC)",65,4822,0,45,4842,12468,17310,116,13496,3698,758,2940
"MAHARASHTRA","RAPE (SECTION 376 IPC)",894,2591,10,996,2479,19097,21576,20,20002,1554,215,1339
"MANIPUR","RAPE (SECTION 376 IPC)",46,46,26,54,12,85,97,1,95,1,0,1
"MEGHALAYA","RAPE (SECTION 376 IPC)",266,182,44,304,100,605,705,0,690,15,7,8
"MIZORAM","RAPE (SECTION 376 IPC)",16,122,0,42,96,112,208,0,136,72,59,13
"NAGALAND","RAPE (SECTION 376 IPC)",8,26,5,8,21,34,55,0,33,22,19,3
"ODISHA","RAPE (SECTION 376 IPC)",121,1666,4,152,1631,5407,7038,0,6098,940,184,756
"PUNJAB","RAPE (SECTION 376 IPC)",354,895,43,510,696,716,1412,2,820,590,201,389
"RAJASTHAN","RAPE (SECTION 376 IPC)",8,1807,0,37,1778,5427,7205,35,5994,1176,408,768
"SIKKIM","RAPE (SECTION 376 IPC)",12,29,5,16,20,75,95,0,45,50,18,32
"TAMIL NADU","RAPE (SECTION 376 IPC)",761,962,62,799,862,2024,2886,0,2420,466,104,362
"TRIPURA","RAPE (SECTION 376 IPC)",90,202,42,35,215,268,483,0,360,123,19,104
"UTTAR PRADESH","RAPE (SECTION 376 IPC)",278,3593,1009,354,2508,6372,8880,54,7075,1751,809,942
"UTTARAKHAND","RAPE (SECTION 376 IPC)",20,184,0,17,187,366,553,0,381,172,93,79
"WEST BENGAL","RAPE (SECTION 376 IPC)",847,1963,71,574,2165,13454,15619,36,14140,1443,124,1319
"TOTAL (STATES)","RAPE (SECTION 376 IPC)",9044,30144,1843,9369,27976,102375,130351,312,110176,19863,4433,15430
"A & N ISLANDS","RAPE (SECTION 376 IPC)",13,17,0,15,15,156,171,0,163,8,3,5
"CHANDIGARH","RAPE (SECTION 376 IPC)",12,34,0,5,41,68,109,0,75,34,11,23
"D & N HAVELI","RAPE (SECTION 376 IPC)",3,5,0,0,8,14,22,0,15,7,2,5
"DAMAN & DIU","RAPE (SECTION 376 IPC)",0,10,0,1,9,6,15,0,12,3,1,2
"DELHI","RAPE (SECTION 376 IPC)",355,892,16,369,862,2320,3182,0,2442,740,368,372
"LAKSHADWEEP","RAPE (SECTION 376 IPC)",0,0,0,0,0,0,0,0,0,0,0,0
"PUDUCHERRY","RAPE (SECTION 376 IPC)",16,15,0,17,14,58,72,0,67,5,3,2
"TOTAL (UTs)","RAPE (SECTION 376 IPC)",399,973,16,407,949,2622,3571,0,2774,797,388,409
"TOTAL (ALL-INDIA)","RAPE (SECTION 376 IPC)",9443,31117,1859,9776,28925,104997,133922,312,112950,20660,4821,15839
"ANDHRA PRADESH","KIDNAPPING AND ABDUCTION (SECTION 363-369, 371-373 IPC)",822,1764,0,786,1800,3403,5203,98,3785,1320,108,1212
"ARUNACHAL PRADESH","KIDNAPPING AND ABDUCTION (SECTION 363-369, 371-373 IPC)",47,49,22,40,34,503,537,9,498,30,7,23
"ASSAM","KIDNAPPING AND ABDUCTION (SECTION 363-369, 371-373 IPC)",2985,2689,1071,3265,1338,3553,4891,0,3475,1416,80,1336
"BIHAR","KIDNAPPING AND ABDUCTION (SECTION 363-369, 371-373 IPC)",2540,4639,32,3491,3656,11968,15624,6,14147,1471,92,1379
"CHHATTISGARH","KIDNAPPING AND ABDUCTION (SECTION 363-369, 371-373 IPC)",82,441,0,84,439,1624,2063,0,1775,288,89,199
"GOA","KIDNAPPING AND ABDUCTION (SECTION 363-369, 371-373 IPC)",14,12,0,14,12,60,72,0,70,2,0,2
"GUJARAT","KIDNAPPING AND ABDUCTION (SECTION 363-369, 371-373 IPC)",256,1939,1,316,1878,13997,15875,41,15082,752,51,701
"HARYANA","KIDNAPPING AND ABDUCTION (SECTION 363-369, 371-373 IPC)",101,660,0,56,705,1538,2243,0,1760,483,62,421
"HIMACHAL PRADESH","KIDNAPPING AND ABDUCTION (SECTION 363-369, 371-373 IPC)",53,131,6,49,129,415,544,5,461,78,16,62
"JAMMU & KASHMIR","KIDNAPPING AND ABDUCTION (SECTION 363-369, 371-373 IPC)",10,884,0,10,884,6711,7595,25,6791,779,2,777
"JHARKHAND","KIDNAPPING AND ABDUCTION (SECTION 363-369, 371-373 IPC)",279,1000,0,330,949,1207,2156,8,1576,572,162,410
"KARNATAKA","KIDNAPPING AND ABDUCTION (SECTION 363-369, 371-373 IPC)",248,1035,42,231,1010,1769,2779,24,2176,579,44,535
"KERALA","KIDNAPPING AND ABDUCTION (SECTION 363-369, 371-373 IPC)",108,253,3,106,252,1181,1433,0,1328,105,6,99
"MADHYA PRADESH","KIDNAPPING AND ABDUCTION (SECTION 363-369, 371-373 IPC)",77,1648,0,104,1621,5139,6760,11,5376,1373,383,990
"MAHARASHTRA","KIDNAPPING AND ABDUCTION (SECTION 363-369, 371-373 IPC)",877,1775,37,959,1656,13245,14901,25,13984,892,32,860
"MANIPUR","KIDNAPPING AND ABDUCTION (SECTION 363-369, 371-373 IPC)",113,101,111,101,2,53,55,0,54,1,0,1
"MEGHALAYA","KIDNAPPING AND ABDUCTION (SECTION 363-369, 371-373 IPC)",76,6,4,66,12,106,118,0,114,4,0,4
"MIZORAM","KIDNAPPING AND ABDUCTION (SECTION 363-369, 371-373 IPC)",0,3,0,0,3,0,3,0,1,2,2,0
"NAGALAND","KIDNAPPING AND ABDUCTION (SECTION 363-369, 371-373 IPC)",3,7,2,3,5,4,9,0,5,4,3,1
"ODISHA","KIDNAPPING AND ABDUCTION (SECTION 363-369, 371-373 IPC)",148,1347,0,168,1327,4029,5356,0,4685,671,46,625
"PUNJAB","KIDNAPPING AND ABDUCTION (SECTION 363-369, 371-373 IPC)",619,731,72,868,410,1530,1940,3,1726,211,44,167
"RAJASTHAN","KIDNAPPING AND ABDUCTION (SECTION 363-369, 371-373 IPC)",64,1565,0,66,1563,9380,10943,44,9685,1214,370,844
"SIKKIM","KIDNAPPING AND ABDUCTION (SECTION 363-369, 371-373 IPC)",1,8,0,4,5,18,23,0,18,5,2,3
"TAMIL NADU","KIDNAPPING AND ABDUCTION (SECTION 363-369, 371-373 IPC)",1714,1557,99,1656,1516,2827,4343,0,3199,1144,119,1025
"TRIPURA","KIDNAPPING AND ABDUCTION (SECTION 363-369, 371-373 IPC)",43,120,11,6,146,152,298,0,244,54,7,47
"UTTAR PRADESH","KIDNAPPING AND ABDUCTION (SECTION 363-369, 371-373 IPC)",3247,20565,9599,4389,9824,16959,26783,415,21929,4439,2155,2284
"UTTARAKHAND","KIDNAPPING AND ABDUCTION (SECTION 363-369, 371-373 IPC)",47,242,4,44,241,1047,1288,0,1026,262,152,110
"WEST BENGAL","KIDNAPPING AND ABDUCTION (SECTION 363-369, 371-373 IPC)",1308,3352,413,1253,2994,12461,15455,45,14294,1116,38,1078
"TOTAL (STATES)","KIDNAPPING AND ABDUCTION (SECTION 363-369, 371-373 IPC)",15882,48523,11529,18465,34411,114879,149290,759,129264,19267,4072,15195
"A & N ISLANDS","KIDNAPPING AND ABDUCTION (SECTION 363-369, 371-373 IPC)",1,7,0,1,7,67,74,0,72,2,1,1
"CHANDIGARH","KIDNAPPING AND ABDUCTION (SECTION 363-369, 371-373 IPC)",22,48,0,9,61,44,105,0,83,22,6,16
"D & N HAVELI","KIDNAPPING AND ABDUCTION (SECTION 363-369, 371-373 IPC)",2,11,0,1,12,50,62,0,54,8,1,7
"DAMAN & DIU","KIDNAPPING AND ABDUCTION (SECTION 363-369, 371-373 IPC)",8,0,0,0,8,4,12,0,6,6,0,6
"DELHI","KIDNAPPING AND ABDUCTION (SECTION 363-369, 371-373 IPC)",106,478,42,120,422,1753,2175,0,1675,500,190,310
"LAKSHADWEEP","KIDNAPPING AND ABDUCTION (SECTION 363-369, 371-373 IPC)",0,0,0,0,0,0,0,0,0,0,0,0
"PUDUCHERRY","KIDNAPPING AND ABDUCTION (SECTION 363-369, 371-373 IPC)",3,16,0,4,15,64,79,0,72,7,3,4
"TOTAL (UTs)","KIDNAPPING AND ABDUCTION (SECTION 363-369, 371-373 IPC)",142,560,42,135,525,1982,2507,0,1962,545,201,344
"TOTAL (ALL-INDIA)","KIDNAPPING AND ABDUCTION (SECTION 363-369, 371-373 IPC)",16024,49083,11571,18600,34936,116861,151797,759,131226,19812,4273,15539
"ANDHRA PRADESH","DOWRY DEATH (SECTION 304-B IPC)",667,1267,0,543,1391,2664,4055,5,2875,1175,146,1029
"ARUNACHAL PRADESH","DOWRY DEATH (SECTION 304-B IPC)",0,2,0,2,0,0,0,0,0,0,0,0
"ASSAM","DOWRY DEATH (SECTION 304-B IPC)",339,215,61,340,153,635,788,0,718,70,18,52
"BIHAR","DOWRY DEATH (SECTION 304-B IPC)",3251,3994,21,3483,3741,13343,17084,0,15130,1954,314,1640
"CHHATTISGARH","DOWRY DEATH (SECTION 304-B IPC)",3,211,0,1,213,946,1159,0,889,270,106,164
"GOA","DOWRY DEATH (SECTION 304-B IPC)",2,0,0,0,2,26,28,0,28,0,0,0
"GUJARAT","DOWRY DEATH (SECTION 304-B IPC)",4,38,0,4,38,1658,1696,0,1628,68,0,68
"HARYANA","DOWRY DEATH (SECTION 304-B IPC)",53,481,0,66,468,1156,1624,0,1171,453,125,328
"HIMACHAL PRADESH","DOWRY DEATH (SECTION 304-B IPC)",0,4,0,0,4,80,84,0,74,10,0,10
"JAMMU & KASHMIR","DOWRY DEATH (SECTION 304-B IPC)",5,23,0,5,23,144,167,0,153,14,2,12
"JHARKHAND","DOWRY DEATH (SECTION 304-B IPC)",475,444,0,429,490,973,1463,4,1003,456,173,283
"KARNATAKA","DOWRY DEATH (SECTION 304-B IPC)",119,539,6,113,539,1913,2452,5,1942,505,62,443
"KERALA","DOWRY DEATH (SECTION 304-B IPC)",17,38,1,24,30,327,357,3,331,23,2,21
"MADHYA PRADESH","DOWRY DEATH (SECTION 304-B IPC)",42,2142,0,38,2146,6522,8668,51,7007,1610,536,1074
"MAHARASHTRA","DOWRY DEATH (SECTION 304-B IPC)",505,1141,2,515,1129,10730,11859,16,11242,601,85,516
"MANIPUR","DOWRY DEATH (SECTION 304-B IPC)",5,0,0,5,0,0,0,0,0,0,0,0
"MEGHALAYA","DOWRY DEATH (SECTION 304-B IPC)",3,4,0,7,0,13,13,0,13,0,0,0
"MIZORAM","DOWRY DEATH (SECTION 304-B IPC)",0,0,0,0,0,0,0,0,0,0,0,0
"NAGALAND","DOWRY DEATH (SECTION 304-B IPC)",0,0,0,0,0,0,0,0,0,0,0,0
"ODISHA","DOWRY DEATH (SECTION 304-B IPC)",181,903,0,209,875,2811,3686,0,2943,743,45,698
"PUNJAB","DOWRY DEATH (SECTION 304-B IPC)",401,274,15,437,223,813,1036,0,820,216,109,107
"RAJASTHAN","DOWRY DEATH (SECTION 304-B IPC)",20,631,0,22,629,3002,3631,32,3106,493,196,297
"SIKKIM","DOWRY DEATH (SECTION 304-B IPC)",2,9,2,5,4,0,4,0,4,0,0,0
"TAMIL NADU","DOWRY DEATH (SECTION 304-B IPC)",351,278,6,280,343,987,1330,0,1040,290,59,231
"TRIPURA","DOWRY DEATH (SECTION 304-B IPC)",20,87,19,39,49,82,131,0,104,27,8,19
"UTTAR PRADESH","DOWRY DEATH (SECTION 304-B IPC)",1462,9884,3307,1803,6236,21917,28153,107,24143,3903,1936,1967
"UTTARAKHAND","DOWRY DEATH (SECTION 304-B IPC)",55,147,0,13,189,542,731,0,468,263,144,119
"WEST BENGAL","DOWRY DEATH (SECTION 304-B IPC)",627,1345,49,578,1345,3592,4937,3,3854,1080,79,1001
"TOTAL (STATES)","DOWRY DEATH (SECTION 304-B IPC)",8609,24101,3489,8961,20260,74876,95136,226,80686,14224,4145,10079
"A & N ISLANDS","DOWRY DEATH (SECTION 304-B IPC)",0,3,0,0,3,5,8,0,8,0,0,0
"CHANDIGARH","DOWRY DEATH (SECTION 304-B IPC)",3,14,0,2,15,6,21,0,8,13,3,10
"D & N HAVELI","DOWRY DEATH (SECTION 304-B IPC)",0,0,0,0,0,4,4,0,4,0,0,0
"DAMAN & DIU","DOWRY DEATH (SECTION 304-B IPC)",0,0,0,0,0,0,0,0,0,0,0,0
"DELHI","DOWRY DEATH (SECTION 304-B IPC)",202,300,9,176,317,2121,2438,0,2134,304,148,156
"LAKSHADWEEP","DOWRY DEATH (SECTION 304-B IPC)",0,0,0,0,0,0,0,0,0,0,0,0
"PUDUCHERRY","DOWRY DEATH (SECTION 304-B IPC)",8,0,0,3,5,17,22,0,21,1,0,1
"TOTAL (UTs)","DOWRY DEATH (SECTION 304-B IPC)",213,317,9,181,340,2153,2493,0,2175,318,151,167
"TOTAL (ALL-INDIA)","DOWRY DEATH (SECTION 304-B IPC)",8822,24418,3498,9142,20600,77029,97629,226,82861,14542,4296,10246
"ANDHRA PRADESH","CRUELTY BY HUSBAND OR HIS RELATIVES (SECTION 498-A IPC)",5465,21251,0,5377,21339,38048,59387,5158,39554,14675,1586,13089
"ARUNACHAL PRADESH","CRUELTY BY HUSBAND OR HIS RELATIVES (SECTION 498-A IPC)",9,26,4,11,20,77,97,2,91,4,2,2
"ASSAM","CRUELTY BY HUSBAND OR HIS RELATIVES (SECTION 498-A IPC)",3619,5435,1703,3588,3763,7384,11147,272,8152,2723,287,2436
"BIHAR","CRUELTY BY HUSBAND OR HIS RELATIVES (SECTION 498-A IPC)",5436,6963,111,5318,6970,13712,20682,314,17857,2511,368,2143
"CHHATTISGARH","CRUELTY BY HUSBAND OR HIS RELATIVES (SECTION 498-A IPC)",105,2581,0,111,2575,10174,12749,1020,9745,1984,604,1380
"GOA","CRUELTY BY HUSBAND OR HIS RELATIVES (SECTION 498-A IPC)",29,54,4,59,20,148,168,0,147,21,1,20
"GUJARAT","CRUELTY BY HUSBAND OR HIS RELATIVES (SECTION 498-A IPC)",1063,19982,0,1407,19638,122491,142129,493,131733,9903,299,9604
"HARYANA","CRUELTY BY HUSBAND OR HIS RELATIVES (SECTION 498-A IPC)",669,3606,0,636,3639,15012,18651,127,14197,4327,345,3982
"HIMACHAL PRADESH","CRUELTY BY HUSBAND OR HIS RELATIVES (SECTION 498-A IPC)",112,505,7,91,519,3149,3668,192,3050,426,15,411
"JAMMU & KASHMIR","CRUELTY BY HUSBAND OR HIS RELATIVES (SECTION 498-A IPC)",11,634,0,11,634,1585,2219,205,1813,201,2,199
"JHARKHAND","CRUELTY BY HUSBAND OR HIS RELATIVES (SECTION 498-A IPC)",704,2207,5,1095,1811,2267,4078,77,2836,1165,251,914
"KARNATAKA","CRUELTY BY HUSBAND OR HIS RELATIVES (SECTION 498-A IPC)",1027,6317,164,1261,5919,13399,19318,263,14745,4310,174,4136
"KERALA","CRUELTY BY HUSBAND OR HIS RELATIVES (SECTION 498-A IPC)",993,6923,1,1203,6712,26731,33443,140,28944,4359,254,4105
"MADHYA PRADESH","CRUELTY BY HUSBAND OR HIS RELATIVES (SECTION 498-A IPC)",75,11104,0,69,11110,35967,47077,2515,38448,6114,1937,4177
"MAHARASHTRA","CRUELTY BY HUSBAND OR HIS RELATIVES (SECTION 498-A IPC)",6901,27379,40,7563,26677,187451,214128,2062,190956,21110,372,20738
"MANIPUR","CRUELTY BY HUSBAND OR HIS RELATIVES (SECTION 498-A IPC)",38,21,16,36,7,3,10,0,10,0,0,0
"MEGHALAYA","CRUELTY BY HUSBAND OR HIS RELATIVES (SECTION 498-A IPC)",21,14,1,22,12,46,58,0,58,0,0,0
"MIZORAM","CRUELTY BY HUSBAND OR HIS RELATIVES (SECTION 498-A IPC)",0,7,0,0,7,1,8,0,0,8,7,1
"NAGALAND","CRUELTY BY HUSBAND OR HIS RELATIVES (SECTION 498-A IPC)",0,0,0,0,0,1,1,0,1,0,0,0
"ODISHA","CRUELTY BY HUSBAND OR HIS RELATIVES (SECTION 498-A IPC)",649,4699,9,435,4904,16362,21266,0,18636,2630,256,2374
"PUNJAB","CRUELTY BY HUSBAND OR HIS RELATIVES (SECTION 498-A IPC)",1546,2288,161,2183,1490,8844,10334,0,9029,1305,408,897
"RAJASTHAN","CRUELTY BY HUSBAND OR HIS RELATIVES (SECTION 498-A IPC)",151,9949,0,131,9969,43468,53437,2060,44849,6528,2341,4187
"SIKKIM","CRUELTY BY HUSBAND OR HIS RELATIVES (SECTION 498-A IPC)",3,6,1,4,4,16,20,0,10,10,6,4
"TAMIL NADU","CRUELTY BY HUSBAND OR HIS RELATIVES (SECTION 498-A IPC)",1371,4019,63,2235,3092,7115,10207,2,7841,2364,495,1869
"TRIPURA","CRUELTY BY HUSBAND OR HIS RELATIVES (SECTION 498-A IPC)",583,1147,152,282,1296,1988,3284,0,1686,1598,270,1328
"UTTAR PRADESH","CRUELTY BY HUSBAND OR HIS RELATIVES (SECTION 498-A IPC)",4169,36115,9519,11076,19689,54863,74552,1771,62614,10167,5105,5062
"UTTARAKHAND","CRUELTY BY HUSBAND OR HIS RELATIVES (SECTION 498-A IPC)",29,484,7,120,386,2609,2995,82,2577,336,175,161
"WEST BENGAL","CRUELTY BY HUSBAND OR HIS RELATIVES (SECTION 498-A IPC)",5879,22911,1445,4262,23083,95405,118488,412,109132,8944,377,8567
"TOTAL (STATES)","CRUELTY BY HUSBAND OR HIS RELATIVES (SECTION 498-A IPC)",40657,196627,13413,48586,175285,708316,883601,17167,758711,107723,15937,91786
"A & N ISLANDS","CRUELTY BY HUSBAND OR HIS RELATIVES (SECTION 498-A IPC)",3,4,0,4,3,140,143,0,140,3,0,3
"CHANDIGARH","CRUELTY BY HUSBAND OR HIS RELATIVES (SECTION 498-A IPC)",34,86,1,26,93,477,570,0,474,96,17,79
"D & N HAVELI","CRUELTY BY HUSBAND OR HIS RELATIVES (SECTION 498-A IPC)",4,0,0,0,4,44,48,0,44,4,0,4
"DAMAN & DIU","CRUELTY BY HUSBAND OR HIS RELATIVES (SECTION 498-A IPC)",0,11,0,3,8,42,50,0,31,19,0,19
"DELHI","CRUELTY BY HUSBAND OR HIS RELATIVES (SECTION 498-A IPC)",79,1026,41,438,626,14766,15392,0,13989,1403,448,955
"LAKSHADWEEP","CRUELTY BY HUSBAND OR HIS RELATIVES (SECTION 498-A IPC)",0,1,0,1,0,2,2,2,0,0,0,0
"PUDUCHERRY","CRUELTY BY HUSBAND OR HIS RELATIVES (SECTION 498-A IPC)",10,7,0,6,11,66,77,0,56,21,0,21
"TOTAL (UTs)","CRUELTY BY HUSBAND OR HIS RELATIVES (SECTION 498-A IPC)",130,1135,42,478,745,15537,16282,2,14734,1546,465,1081
"TOTAL (ALL-INDIA)","CRUELTY BY HUSBAND OR HIS RELATIVES (SECTION 498-A IPC)",40787,197762,13455,49064,176030,723853,899883,17169,773445,109269,16402,92867
"ANDHRA PRADESH","ASSAULT ON WOMEN WITH INTENT TO OUTRAGE HER MODESTY (SECTION 354 IPC)",1364,4834,0,1471,4727,7351,12078,522,8192,3364,419,2945
"ARUNACHAL PRADESH","ASSAULT ON WOMEN WITH INTENT TO OUTRAGE HER MODESTY (SECTION 354 IPC)",41,77,13,53,52,459,511,2,478,31,12,19
"ASSAM","ASSAULT ON WOMEN WITH INTENT TO OUTRAGE HER MODESTY (SECTION 354 IPC)",1337,2250,880,1497,1210,2492,3702,25,2753,924,97,827
"BIHAR","ASSAULT ON WOMEN WITH INTENT TO OUTRAGE HER MODESTY (SECTION 354 IPC)",585,278,35,189,639,3556,4195,97,3489,609,59,550
"CHHATTISGARH","ASSAULT ON WOMEN WITH INTENT TO OUTRAGE HER MODESTY (SECTION 354 IPC)",61,1891,0,73,1879,8425,10304,189,8609,1506,491,1015
"GOA","ASSAULT ON WOMEN WITH INTENT TO OUTRAGE HER MODESTY (SECTION 354 IPC)",14,42,1,31,24,114,138,0,120,18,1,17
"GUJARAT","ASSAULT ON WOMEN WITH INTENT TO OUTRAGE HER MODESTY (SECTION 354 IPC)",69,1118,0,78,1109,10312,11421,53,10673,695,8,687
"HARYANA","ASSAULT ON WOMEN WITH INTENT TO OUTRAGE HER MODESTY (SECTION 354 IPC)",65,698,0,30,733,2402,3135,0,2402,733,147,586
"HIMACHAL PRADESH","ASSAULT ON WOMEN WITH INTENT TO OUTRAGE HER MODESTY (SECTION 354 IPC)",50,317,0,35,332,1969,2301,55,1995,251,33,218
"JAMMU & KASHMIR","ASSAULT ON WOMEN WITH INTENT TO OUTRAGE HER MODESTY (SECTION 354 IPC)",10,2814,0,10,2814,12757,15571,688,12386,2497,155,2342
"JHARKHAND","ASSAULT ON WOMEN WITH INTENT TO OUTRAGE HER MODESTY (SECTION 354 IPC)",109,355,0,109,355,727,1082,7,721,354,149,205
"KARNATAKA","ASSAULT ON WOMEN WITH INTENT TO OUTRAGE HER MODESTY (SECTION 354 IPC)",550,3982,63,608,3861,7583,11444,277,8350,2817,174,2643
"KERALA","ASSAULT ON WOMEN WITH INTENT TO OUTRAGE HER MODESTY (SECTION 354 IPC)",474,4167,1,509,4131,14677,18808,140,16466,2202,285,1917
"MADHYA PRADESH","ASSAULT ON WOMEN WITH INTENT TO OUTRAGE HER MODESTY (SECTION 354 IPC)",11,8085,0,34,8062,27063,35125,2272,28080,4773,1655,3118
"MAHARASHTRA","ASSAULT ON WOMEN WITH INTENT TO OUTRAGE HER MODESTY (SECTION 354 IPC)",1323,4885,10,1475,4723,34065,38788,758,35042,2988,256,2732
"MANIPUR","ASSAULT ON WOMEN WITH INTENT TO OUTRAGE HER MODESTY (SECTION 354 IPC)",52,34,29,50,7,10,17,0,17,0,0,0
"MEGHALAYA","ASSAULT ON WOMEN WITH INTENT TO OUTRAGE HER MODESTY (SECTION 354 IPC)",22,45,1,32,34,219,253,0,244,9,2,7
"MIZORAM","ASSAULT ON WOMEN WITH INTENT TO OUTRAGE HER MODESTY (SECTION 354 IPC)",5,82,0,9,78,71,149,0,80,69,47,22
"NAGALAND","ASSAULT ON WOMEN WITH INTENT TO OUTRAGE HER MODESTY (SECTION 354 IPC)",4,16,1,4,15,10,25,0,13,12,12,0
"ODISHA","ASSAULT ON WOMEN WITH INTENT TO OUTRAGE HER MODESTY (SECTION 354 IPC)",288,6060,31,438,5879,24969,30848,0,28413,2435,246,2189
"PUNJAB","ASSAULT ON WOMEN WITH INTENT TO OUTRAGE HER MODESTY (SECTION 354 IPC)",333,413,19,443,284,1191,1475,0,1222,253,79,174
"RAJASTHAN","ASSAULT ON WOMEN WITH INTENT TO OUTRAGE HER MODESTY (SECTION 354 IPC)",4,2658,0,6,2656,14322,16978,651,14173,2154,1145,1009
"SIKKIM","ASSAULT ON WOMEN WITH INTENT TO OUTRAGE HER MODESTY (SECTION 354 IPC)",12,17,12,8,9,28,37,1,29,7,1,6
"TAMIL NADU","ASSAULT ON WOMEN WITH INTENT TO OUTRAGE HER MODESTY (SECTION 354 IPC)",1018,2091,66,1069,1974,4704,6678,0,5483,1195,387,808
"TRIPURA","ASSAULT ON WOMEN WITH INTENT TO OUTRAGE HER MODESTY (SECTION 354 IPC)",107,375,29,86,367,225,592,0,247,345,44,301
"UTTAR PRADESH","ASSAULT ON WOMEN WITH INTENT TO OUTRAGE HER MODESTY (SECTION 354 IPC)",205,5143,590,347,4411,10053,14464,127,11854,2483,1506,977
"UTTARAKHAND","ASSAULT ON WOMEN WITH INTENT TO OUTRAGE HER MODESTY (SECTION 354 IPC)",6,199,0,8,197,624,821,22,590,209,168,41
"WEST BENGAL","ASSAULT ON WOMEN WITH INTENT TO OUTRAGE HER MODESTY (SECTION 354 IPC)",571,2879,133,420,2897,12653,15550,87,14268,1195,138,1057
"TOTAL (STATES)","ASSAULT ON WOMEN WITH INTENT TO OUTRAGE HER MODESTY (SECTION 354 IPC)",8690,55805,1914,9122,53459,203031,256490,5973,216389,34128,7716,26412
"A & N ISLANDS","ASSAULT ON WOMEN WITH INTENT TO OUTRAGE HER MODESTY (SECTION 354 IPC)",16,20,0,22,14,264,278,0,265,13,1,12
"CHANDIGARH","ASSAULT ON WOMEN WITH INTENT TO OUTRAGE HER MODESTY (SECTION 354 IPC)",7,54,0,33,28,104,132,0,107,25,1,24
"D & N HAVELI","ASSAULT ON WOMEN WITH INTENT TO OUTRAGE HER MODESTY (SECTION 354 IPC)",1,2,0,1,2,33,35,0,30,5,1,4
"DAMAN & DIU","ASSAULT ON WOMEN WITH INTENT TO OUTRAGE HER MODESTY (SECTION 354 IPC)",5,0,0,5,0,1,1,0,0,1,0,1
"DELHI","ASSAULT ON WOMEN WITH INTENT TO OUTRAGE HER MODESTY (SECTION 354 IPC)",676,939,31,698,886,4990,5876,0,4867,1009,452,557
"LAKSHADWEEP","ASSAULT ON WOMEN WITH INTENT TO OUTRAGE HER MODESTY (SECTION 354 IPC)",0,0,0,0,0,0,0,0,0,0,0,0
"PUDUCHERRY","ASSAULT ON WOMEN WITH INTENT TO OUTRAGE HER MODESTY (SECTION 354 IPC)",21,7,0,15,13,315,328,0,262,66,12,54
"TOTAL (UTs)","ASSAULT ON WOMEN WITH INTENT TO OUTRAGE HER MODESTY (SECTION 354 IPC)",726,1022,31,774,943,5707,6650,0,5531,1119,467,652
"TOTAL (ALL-INDIA)","ASSAULT ON WOMEN WITH INTENT TO OUTRAGE HER MODESTY (SECTION 354 IPC)",9416,56827,1945,9896,54402,208738,263140,5973,221920,35247,8183,27064
"ANDHRA PRADESH","INSULT TO THE MODESTY OF WOMEN (SECTION 509 IPC)",591,4348,0,862,4077,4666,8743,826,5427,2490,690,1800
"ARUNACHAL PRADESH","INSULT TO THE MODESTY OF WOMEN (SECTION 509 IPC)",0,0,0,0,0,17,17,0,17,0,0,0
"ASSAM","INSULT TO THE MODESTY OF WOMEN (SECTION 509 IPC)",28,12,5,27,8,9,17,0,16,1,0,1
"BIHAR","INSULT TO THE MODESTY OF WOMEN (SECTION 509 IPC)",3,39,2,0,40,69,109,7,77,25,0,25
"CHHATTISGARH","INSULT TO THE MODESTY OF WOMEN (SECTION 509 IPC)",2,193,0,0,195,861,1056,0,899,157,38,119
"GOA","INSULT TO THE MODESTY OF WOMEN (SECTION 509 IPC)",13,17,1,21,8,38,46,1,41,4,1,3
"GUJARAT","INSULT TO THE MODESTY OF WOMEN (SECTION 509 IPC)",6,117,0,3,120,1429,1549,3,1445,101,16,85
"HARYANA","INSULT TO THE MODESTY OF WOMEN (SECTION 509 IPC)",43,558,0,24,577,1472,2049,0,1503,546,313,233
"HIMACHAL PRADESH","INSULT TO THE MODESTY OF WOMEN (SECTION 509 IPC)",3,91,0,15,79,279,358,9,333,16,2,14
"JAMMU & KASHMIR","INSULT TO THE MODESTY OF WOMEN (SECTION 509 IPC)",3,447,0,3,447,2025,2472,7,2026,439,149,290
"JHARKHAND","INSULT TO THE MODESTY OF WOMEN (SECTION 509 IPC)",8,51,0,30,29,67,96,0,80,16,6,10
"KARNATAKA","INSULT TO THE MODESTY OF WOMEN (SECTION 509 IPC)",1,147,0,11,137,100,237,0,124,113,2,111
"KERALA","INSULT TO THE MODESTY OF WOMEN (SECTION 509 IPC)",55,538,0,77,516,1494,2010,15,1707,288,101,187
"MADHYA PRADESH","INSULT TO THE MODESTY OF WOMEN (SECTION 509 IPC)",4,1056,0,2,1058,2524,3582,197,2829,556,190,366
"MAHARASHTRA","INSULT TO THE MODESTY OF WOMEN (SECTION 509 IPC)",306,1548,5,416,1433,10960,12393,295,11404,694,34,660
"MANIPUR","INSULT TO THE MODESTY OF WOMEN (SECTION 509 IPC)",1,0,0,1,0,1,1,0,1,0,0,0
"MEGHALAYA","INSULT TO THE MODESTY OF WOMEN (SECTION 509 IPC)",0,0,0,0,0,1,1,0,1,0,0,0
"MIZORAM","INSULT TO THE MODESTY OF WOMEN (SECTION 509 IPC)",0,1,0,0,1,0,1,0,0,1,1,0
"NAGALAND","INSULT TO THE MODESTY OF WOMEN (SECTION 509 IPC)",0,0,0,0,0,2,2,0,2,0,0,0
"ODISHA","INSULT TO THE MODESTY OF WOMEN (SECTION 509 IPC)",38,376,0,43,371,1788,2159,0,1899,260,23,237
"PUNJAB","INSULT TO THE MODESTY OF WOMEN (SECTION 509 IPC)",49,45,4,66,24,82,106,0,86,20,5,15
"RAJASTHAN","INSULT TO THE MODESTY OF WOMEN (SECTION 509 IPC)",0,20,0,0,20,88,108,0,97,11,4,7
"SIKKIM","INSULT TO THE MODESTY OF WOMEN (SECTION 509 IPC)",0,0,0,0,0,0,0,0,0,0,0,0
"TAMIL NADU","INSULT TO THE MODESTY OF WOMEN (SECTION 509 IPC)",99,470,20,217,332,1448,1780,0,1363,417,154,263
"TRIPURA","INSULT TO THE MODESTY OF WOMEN (SECTION 509 IPC)",0,15,0,0,15,13,28,0,18,10,1,9
"UTTAR PRADESH","INSULT TO THE MODESTY OF WOMEN (SECTION 509 IPC)",2,14,2,0,14,2490,2504,18,320,2166,1167,999
"UTTARAKHAND","INSULT TO THE MODESTY OF WOMEN (SECTION 509 IPC)",2,103,0,7,98,766,864,4,784,76,66,10
"WEST BENGAL","INSULT TO THE MODESTY OF WOMEN (SECTION 509 IPC)",102,617,69,244,406,167,573,21,317,235,99,136
"TOTAL (STATES)","INSULT TO THE MODESTY OF WOMEN (SECTION 509 IPC)",1359,10823,108,2069,10005,32856,42861,1403,32816,8642,3062,5580
"A & N ISLANDS","INSULT TO THE MODESTY OF WOMEN (SECTION 509 IPC)",5,6,0,7,4,46,50,0,49,1,0,1
"CHANDIGARH","INSULT TO THE MODESTY OF WOMEN (SECTION 509 IPC)",1,32,0,11,22,39,61,0,51,10,0,10
"D & N HAVELI","INSULT TO THE MODESTY OF WOMEN (SECTION 509 IPC)",0,0,0,0,0,4,4,0,2,2,0,2
"DAMAN & DIU","INSULT TO THE MODESTY OF WOMEN (SECTION 509 IPC)",0,0,0,0,0,2,2,0,0,2,0,2
"DELHI","INSULT TO THE MODESTY OF WOMEN (SECTION 509 IPC)",114,231,7,145,193,536,729,0,549,180,73,107
"LAKSHADWEEP","INSULT TO THE MODESTY OF WOMEN (SECTION 509 IPC)",0,0,0,0,0,0,0,0,0,0,0,0
"PUDUCHERRY","INSULT TO THE MODESTY OF WOMEN (SECTION 509 IPC)",8,17,0,2,23,127,150,0,120,30,1,29
"TOTAL (UTs)","INSULT TO THE MODESTY OF WOMEN (SECTION 509 IPC)",128,286,7,165,242,754,996,0,771,225,74,151
"TOTAL (ALL-INDIA)","INSULT TO THE MODESTY OF WOMEN (SECTION 509 IPC)",1487,11109,115,2234,10247,33610,43857,1403,33587,8867,3136,5731
"ANDHRA PRADESH","IMPORTATION OF GIRLS FROM FOREIGN COUNTRY(SECTION 366-B IPC)",0,0,0,0,0,2,2,0,2,0,0,0
"ARUNACHAL PRADESH","IMPORTATION OF GIRLS FROM FOREIGN COUNTRY(SECTION 366-B IPC)",0,0,0,0,0,0,0,0,0,0,0,0
"ASSAM","IMPORTATION OF GIRLS FROM FOREIGN COUNTRY(SECTION 366-B IPC)",0,2,0,2,0,4,4,0,2,2,0,2
"BIHAR","IMPORTATION OF GIRLS FROM FOREIGN COUNTRY(SECTION 366-B IPC)",13,6,0,15,4,415,419,0,354,65,7,58
"CHHATTISGARH","IMPORTATION OF GIRLS FROM FOREIGN COUNTRY(SECTION 366-B IPC)",1,0,0,0,1,12,13,1,11,1,1,0
"GOA","IMPORTATION OF GIRLS FROM FOREIGN COUNTRY(SECTION 366-B IPC)",0,0,0,0,0,0,0,0,0,0,0,0
"GUJARAT","IMPORTATION OF GIRLS FROM FOREIGN COUNTRY(SECTION 366-B IPC)",0,0,0,0,0,0,0,0,0,0,0,0
"HARYANA","IMPORTATION OF GIRLS FROM FOREIGN COUNTRY(SECTION 366-B IPC)",0,0,0,0,0,0,0,0,0,0,0,0
"HIMACHAL PRADESH","IMPORTATION OF GIRLS FROM FOREIGN COUNTRY(SECTION 366-B IPC)",0,0,0,0,0,0,0,0,0,0,0,0
"JAMMU & KASHMIR","IMPORTATION OF GIRLS FROM FOREIGN COUNTRY(SECTION 366-B IPC)",0,0,0,0,0,0,0,0,0,0,0,0
"JHARKHAND","IMPORTATION OF GIRLS FROM FOREIGN COUNTRY(SECTION 366-B IPC)",10,3,0,10,3,20,23,1,19,3,1,2
"KARNATAKA","IMPORTATION OF GIRLS FROM FOREIGN COUNTRY(SECTION 366-B IPC)",0,0,0,0,0,2,2,0,2,0,0,0
"KERALA","IMPORTATION OF GIRLS FROM FOREIGN COUNTRY(SECTION 366-B IPC)",0,0,0,0,0,0,0,0,0,0,0,0
"MADHYA PRADESH","IMPORTATION OF GIRLS FROM FOREIGN COUNTRY(SECTION 366-B IPC)",5,10,0,0,15,192,207,13,180,14,3,11
"MAHARASHTRA","IMPORTATION OF GIRLS FROM FOREIGN COUNTRY(SECTION 366-B IPC)",0,0,0,0,0,0,0,0,0,0,0,0
"MANIPUR","IMPORTATION OF GIRLS FROM FOREIGN COUNTRY(SECTION 366-B IPC)",0,0,0,0,0,0,0,0,0,0,0,0
"MEGHALAYA","IMPORTATION OF GIRLS FROM FOREIGN COUNTRY(SECTION 366-B IPC)",2,0,0,0,2,0,2,0,2,0,0,0
"MIZORAM","IMPORTATION OF GIRLS FROM FOREIGN COUNTRY(SECTION 366-B IPC)",0,0,0,0,0,0,0,0,0,0,0,0
"NAGALAND","IMPORTATION OF GIRLS FROM FOREIGN COUNTRY(SECTION 366-B IPC)",0,0,0,0,0,0,0,0,0,0,0,0
"ODISHA","IMPORTATION OF GIRLS FROM FOREIGN COUNTRY(SECTION 366-B IPC)",0,0,0,0,0,8,8,0,8,0,0,0
"PUNJAB","IMPORTATION OF GIRLS FROM FOREIGN COUNTRY(SECTION 366-B IPC)",0,0,0,0,0,0,0,0,0,0,0,0
"RAJASTHAN","IMPORTATION OF GIRLS FROM FOREIGN COUNTRY(SECTION 366-B IPC)",0,0,0,0,0,1,1,0,1,0,0,0
"SIKKIM","IMPORTATION OF GIRLS FROM FOREIGN COUNTRY(SECTION 366-B IPC)",0,0,0,0,0,0,0,0,0,0,0,0
"TAMIL NADU","IMPORTATION OF GIRLS FROM FOREIGN COUNTRY(SECTION 366-B IPC)",0,0,0,0,0,0,0,0,0,0,0,0
"TRIPURA","IMPORTATION OF GIRLS FROM FOREIGN COUNTRY(SECTION 366-B IPC)",0,0,0,0,0,0,0,0,0,0,0,0
"UTTAR PRADESH","IMPORTATION OF GIRLS FROM FOREIGN COUNTRY(SECTION 366-B IPC)",0,0,0,0,0,0,0,0,0,0,0,0
"UTTARAKHAND","IMPORTATION OF GIRLS FROM FOREIGN COUNTRY(SECTION 366-B IPC)",0,0,0,0,0,0,0,0,0,0,0,0
"WEST BENGAL","IMPORTATION OF GIRLS FROM FOREIGN COUNTRY(SECTION 366-B IPC)",5,25,5,5,20,10,30,0,17,13,2,11
"TOTAL (STATES)","IMPORTATION OF GIRLS FROM FOREIGN COUNTRY(SECTION 366-B IPC)",36,46,5,32,45,666,711,15,598,98,14,84
"A & N ISLANDS","IMPORTATION OF GIRLS FROM FOREIGN COUNTRY(SECTION 366-B IPC)",0,0,0,0,0,0,0,0,0,0,0,0
"CHANDIGARH","IMPORTATION OF GIRLS FROM FOREIGN COUNTRY(SECTION 366-B IPC)",0,0,0,0,0,0,0,0,0,0,0,0
"D & N HAVELI","IMPORTATION OF GIRLS FROM FOREIGN COUNTRY(SECTION 366-B IPC)",0,0,0,0,0,0,0,0,0,0,0,0
"DAMAN & DIU","IMPORTATION OF GIRLS FROM FOREIGN COUNTRY(SECTION 366-B IPC)",0,0,0,0,0,0,0,0,0,0,0,0
"DELHI","IMPORTATION OF GIRLS FROM FOREIGN COUNTRY(SECTION 366-B IPC)",0,0,0,0,0,0,0,0,0,0,0,0
"LAKSHADWEEP","IMPORTATION OF GIRLS FROM FOREIGN COUNTRY(SECTION 366-B IPC)",0,0,0,0,0,0,0,0,0,0,0,0
"PUDUCHERRY","IMPORTATION OF GIRLS FROM FOREIGN COUNTRY(SECTION 366-B IPC)",0,0,0,0,0,0,0,0,0,0,0,0
"TOTAL (UTs)","IMPORTATION OF GIRLS FROM FOREIGN COUNTRY(SECTION 366-B IPC)",0,0,0,0,0,0,0,0,0,0,0,0
"TOTAL (ALL-INDIA)","IMPORTATION OF GIRLS FROM FOREIGN COUNTRY(SECTION 366-B IPC)",36,46,5,32,45,666,711,15,598,98,14,84
"ANDHRA PRADESH","COMMISSION OF SATI PREVENTION ACT",0,0,0,0,0,0,0,0,0,0,0,0
"ARUNACHAL PRADESH","COMMISSION OF SATI PREVENTION ACT",0,0,0,0,0,0,0,0,0,0,0,0
"ASSAM","COMMISSION OF SATI PREVENTION ACT",0,0,0,0,0,0,0,0,0,0,0,0
"BIHAR","COMMISSION OF SATI PREVENTION ACT",0,0,0,0,0,0,0,0,0,0,0,0
"CHHATTISGARH","COMMISSION OF SATI PREVENTION ACT",0,0,0,0,0,0,0,0,0,0,0,0
"GOA","COMMISSION OF SATI PREVENTION ACT",0,0,0,0,0,0,0,0,0,0,0,0
"GUJARAT","COMMISSION OF SATI PREVENTION ACT",0,0,0,0,0,0,0,0,0,0,0,0
"HARYANA","COMMISSION OF SATI PREVENTION ACT",0,0,0,0,0,0,0,0,0,0,0,0
"HIMACHAL PRADESH","COMMISSION OF SATI PREVENTION ACT",0,0,0,0,0,0,0,0,0,0,0,0
"JAMMU & KASHMIR","COMMISSION OF SATI PREVENTION ACT",0,0,0,0,0,0,0,0,0,0,0,0
"JHARKHAND","COMMISSION OF SATI PREVENTION ACT",0,0,0,0,0,0,0,0,0,0,0,0
"KARNATAKA","COMMISSION OF SATI PREVENTION ACT",0,0,0,0,0,0,0,0,0,0,0,0
"KERALA","COMMISSION OF SATI PREVENTION ACT",0,0,0,0,0,0,0,0,0,0,0,0
"MADHYA PRADESH","COMMISSION OF SATI PREVENTION ACT",0,0,0,0,0,0,0,0,0,0,0,0
"MAHARASHTRA","COMMISSION OF SATI PREVENTION ACT",0,0,0,0,0,0,0,0,0,0,0,0
"MANIPUR","COMMISSION OF SATI PREVENTION ACT",0,0,0,0,0,0,0,0,0,0,0,0
"MEGHALAYA","COMMISSION OF SATI PREVENTION ACT",0,0,0,0,0,0,0,0,0,0,0,0
"MIZORAM","COMMISSION OF SATI PREVENTION ACT",0,0,0,0,0,0,0,0,0,0,0,0
"NAGALAND","COMMISSION OF SATI PREVENTION ACT",0,0,0,0,0,0,0,0,0,0,0,0
"ODISHA","COMMISSION OF SATI PREVENTION ACT",0,0,0,0,0,0,0,0,0,0,0,0
"PUNJAB","COMMISSION OF SATI PREVENTION ACT",0,0,0,0,0,0,0,0,0,0,0,0
"RAJASTHAN","COMMISSION OF SATI PREVENTION ACT",0,0,0,0,0,18,18,0,18,0,0,0
"SIKKIM","COMMISSION OF SATI PREVENTION ACT",0,0,0,0,0,0,0,0,0,0,0,0
"TAMIL NADU","COMMISSION OF SATI PREVENTION ACT",0,0,0,0,0,0,0,0,0,0,0,0
"TRIPURA","COMMISSION OF SATI PREVENTION ACT",0,0,0,0,0,0,0,0,0,0,0,0
"UTTAR PRADESH","COMMISSION OF SATI PREVENTION ACT",0,0,0,0,0,0,0,0,0,0,0,0
"UTTARAKHAND","COMMISSION OF SATI PREVENTION ACT",0,0,0,0,0,0,0,0,0,0,0,0
"WEST BENGAL","COMMISSION OF SATI PREVENTION ACT",0,0,0,0,0,0,0,0,0,0,0,0
"TOTAL (STATES)","COMMISSION OF SATI PREVENTION ACT",0,0,0,0,0,18,18,0,18,0,0,0
"A & N ISLANDS","COMMISSION OF SATI PREVENTION ACT",0,0,0,0,0,0,0,0,0,0,0,0
"CHANDIGARH","COMMISSION OF SATI PREVENTION ACT",0,0,0,0,0,0,0,0,0,0,0,0
"D & N HAVELI","COMMISSION OF SATI PREVENTION ACT",0,0,0,0,0,0,0,0,0,0,0,0
"DAMAN & DIU","COMMISSION OF SATI PREVENTION ACT",0,0,0,0,0,0,0,0,0,0,0,0
"DELHI","COMMISSION OF SATI PREVENTION ACT",0,0,0,0,0,0,0,0,0,0,0,0
"LAKSHADWEEP","COMMISSION OF SATI PREVENTION ACT",0,0,0,0,0,0,0,0,0,0,0,0
"PUDUCHERRY","COMMISSION OF SATI PREVENTION ACT",0,0,0,0,0,0,0,0,0,0,0,0
"TOTAL (UTs)","COMMISSION OF SATI PREVENTION ACT",0,0,0,0,0,0,0,0,0,0,0,0
"TOTAL (ALL-INDIA)","COMMISSION OF SATI PREVENTION ACT",0,0,0,0,0,18,18,0,18,0,0,0
"ANDHRA PRADESH"," IMMORAL TRAFFIC (PREVENTION) ACT",482,1354,0,460,1376,3006,4382,1,3148,1233,301,932
"ARUNACHAL PRADESH"," IMMORAL TRAFFIC (PREVENTION) ACT",0,1,0,1,0,2,2,0,2,0,0,0
"ASSAM"," IMMORAL TRAFFIC (PREVENTION) ACT",127,51,23,124,31,170,201,0,180,21,0,21
"BIHAR"," IMMORAL TRAFFIC (PREVENTION) ACT",47,116,14,85,64,322,386,0,350,36,3,33
"CHHATTISGARH"," IMMORAL TRAFFIC (PREVENTION) ACT",0,22,0,0,22,222,244,0,225,19,7,12
"GOA"," IMMORAL TRAFFIC (PREVENTION) ACT",49,100,5,118,26,140,166,0,161,5,3,2
"GUJARAT"," IMMORAL TRAFFIC (PREVENTION) ACT",4,124,0,33,95,3951,4046,0,4033,13,0,13
"HARYANA"," IMMORAL TRAFFIC (PREVENTION) ACT",52,303,0,65,290,1579,1869,0,1531,338,77,261
"HIMACHAL PRADESH"," IMMORAL TRAFFIC (PREVENTION) ACT",0,18,0,4,14,83,97,0,77,20,0,20
"JAMMU & KASHMIR"," IMMORAL TRAFFIC (PREVENTION) ACT",2,13,0,2,13,133,146,0,132,14,0,14
"JHARKHAND"," IMMORAL TRAFFIC (PREVENTION) ACT",8,20,0,17,11,55,66,0,54,12,7,5
"KARNATAKA"," IMMORAL TRAFFIC (PREVENTION) ACT",92,1240,0,162,1170,5513,6683,5,5798,880,241,639
"KERALA"," IMMORAL TRAFFIC (PREVENTION) ACT",69,324,0,51,342,2529,2871,0,2491,380,146,234
"MADHYA PRADESH"," IMMORAL TRAFFIC (PREVENTION) ACT",0,59,0,0,59,590,649,0,582,67,29,38
"MAHARASHTRA"," IMMORAL TRAFFIC (PREVENTION) ACT",944,1621,0,1227,1338,12762,14100,20,13912,168,44,124
"MANIPUR"," IMMORAL TRAFFIC (PREVENTION) ACT",0,0,0,0,0,13,13,0,13,0,0,0
"MEGHALAYA"," IMMORAL TRAFFIC (PREVENTION) ACT",29,20,5,44,0,5,5,0,5,0,0,0
"MIZORAM"," IMMORAL TRAFFIC (PREVENTION) ACT",0,0,0,0,0,2,2,0,0,2,2,0
"NAGALAND"," IMMORAL TRAFFIC (PREVENTION) ACT",2,26,0,0,28,0,28,0,4,24,24,0
"ODISHA"," IMMORAL TRAFFIC (PREVENTION) ACT",7,82,0,16,73,469,542,0,460,82,3,79
"PUNJAB"," IMMORAL TRAFFIC (PREVENTION) ACT",259,402,1,349,311,779,1090,0,900,190,58,132
"RAJASTHAN"," IMMORAL TRAFFIC (PREVENTION) ACT",15,349,0,8,356,2439,2795,0,2717,78,47,31
"SIKKIM"," IMMORAL TRAFFIC (PREVENTION) ACT",5,0,0,0,5,10,15,0,0,15,8,7
"TAMIL NADU"," IMMORAL TRAFFIC (PREVENTION) ACT",245,927,0,452,720,1087,1807,0,1319,488,332,156
"TRIPURA"," IMMORAL TRAFFIC (PREVENTION) ACT",0,0,0,0,0,0,0,0,0,0,0,0
"UTTAR PRADESH"," IMMORAL TRAFFIC (PREVENTION) ACT",16,187,6,19,178,810,988,0,893,95,74,21
"UTTARAKHAND"," IMMORAL TRAFFIC (PREVENTION) ACT",0,61,0,16,45,117,162,0,147,15,15,0
"WEST BENGAL"," IMMORAL TRAFFIC (PREVENTION) ACT",384,455,49,462,328,721,1049,5,912,132,43,89
"TOTAL (STATES)"," IMMORAL TRAFFIC (PREVENTION) ACT",2838,7875,103,3715,6895,37509,44404,31,40046,4327,1464,2863
"A & N ISLANDS"," IMMORAL TRAFFIC (PREVENTION) ACT",30,16,0,19,27,11,38,0,38,0,0,0
"CHANDIGARH"," IMMORAL TRAFFIC (PREVENTION) ACT",5,0,0,0,5,133,138,0,129,9,0,9
"D & N HAVELI"," IMMORAL TRAFFIC (PREVENTION) ACT",0,12,0,0,12,44,56,0,56,0,0,0
"DAMAN & DIU"," IMMORAL TRAFFIC (PREVENTION) ACT",52,24,0,47,29,132,161,0,153,8,0,8
"DELHI"," IMMORAL TRAFFIC (PREVENTION) ACT",43,104,0,59,88,2399,2487,0,2357,130,85,45
"LAKSHADWEEP"," IMMORAL TRAFFIC (PREVENTION) ACT",0,0,0,0,0,0,0,0,0,0,0,0
"PUDUCHERRY"," IMMORAL TRAFFIC (PREVENTION) ACT",0,21,0,21,0,59,59,0,52,7,7,0
"TOTAL (UTs)"," IMMORAL TRAFFIC (PREVENTION) ACT",130,177,0,146,161,2778,2939,0,2785,154,92,62
"TOTAL (ALL-INDIA)"," IMMORAL TRAFFIC (PREVENTION) ACT",2968,8052,103,3861,7056,40287,47343,31,42831,4481,1556,2925
"ANDHRA PRADESH","INDECENT REPRESENTATION OF WOMEN (PROHIBITION) ACT ",19,26,0,6,39,40,79,0,35,44,18,26
"ARUNACHAL PRADESH","INDECENT REPRESENTATION OF WOMEN (PROHIBITION) ACT ",0,0,0,0,0,0,0,0,0,0,0,0
"ASSAM","INDECENT REPRESENTATION OF WOMEN (PROHIBITION) ACT ",0,3,0,1,2,1,3,0,3,0,0,0
"BIHAR","INDECENT REPRESENTATION OF WOMEN (PROHIBITION) ACT ",0,7,5,0,2,53,55,0,43,12,0,12
"CHHATTISGARH","INDECENT REPRESENTATION OF WOMEN (PROHIBITION) ACT ",0,1,0,0,1,1,2,0,2,0,0,0
"GOA","INDECENT REPRESENTATION OF WOMEN (PROHIBITION) ACT ",0,0,0,0,0,0,0,0,0,0,0,0
"GUJARAT","INDECENT REPRESENTATION OF WOMEN (PROHIBITION) ACT ",0,0,0,0,0,93,93,0,84,9,4,5
"HARYANA","INDECENT REPRESENTATION OF WOMEN (PROHIBITION) ACT ",0,10,0,0,10,0,10,0,10,0,0,0
"HIMACHAL PRADESH","INDECENT REPRESENTATION OF WOMEN (PROHIBITION) ACT ",0,0,0,0,0,0,0,0,0,0,0,0
"JAMMU & KASHMIR","INDECENT REPRESENTATION OF WOMEN (PROHIBITION) ACT ",0,0,0,0,0,2,2,0,2,0,0,0
"JHARKHAND","INDECENT REPRESENTATION OF WOMEN (PROHIBITION) ACT ",17,0,0,17,0,3,3,0,3,0,0,0
"KARNATAKA","INDECENT REPRESENTATION OF WOMEN (PROHIBITION) ACT ",0,0,0,0,0,0,0,0,0,0,0,0
"KERALA","INDECENT REPRESENTATION OF WOMEN (PROHIBITION) ACT ",6,9,0,4,11,101,112,0,88,24,6,18
"MADHYA PRADESH","INDECENT REPRESENTATION OF WOMEN (PROHIBITION) ACT ",0,0,0,0,0,0,0,0,0,0,0,0
"MAHARASHTRA","INDECENT REPRESENTATION OF WOMEN (PROHIBITION) ACT ",0,2,0,0,2,433,435,0,433,2,0,2
"MANIPUR","INDECENT REPRESENTATION OF WOMEN (PROHIBITION) ACT ",0,0,0,0,0,0,0,0,0,0,0,0
"MEGHALAYA","INDECENT REPRESENTATION OF WOMEN (PROHIBITION) ACT ",0,0,0,0,0,0,0,0,0,0,0,0
"MIZORAM","INDECENT REPRESENTATION OF WOMEN (PROHIBITION) ACT ",0,0,0,0,0,0,0,0,0,0,0,0
"NAGALAND","INDECENT REPRESENTATION OF WOMEN (PROHIBITION) ACT ",0,0,0,0,0,0,0,0,0,0,0,0
"ODISHA","INDECENT REPRESENTATION OF WOMEN (PROHIBITION) ACT ",0,1,0,0,1,0,1,0,1,0,0,0
"PUNJAB","INDECENT REPRESENTATION OF WOMEN (PROHIBITION) ACT ",0,0,0,0,0,8,8,0,8,0,0,0
"RAJASTHAN","INDECENT REPRESENTATION OF WOMEN (PROHIBITION) ACT ",0,66,0,0,66,625,691,0,603,88,67,21
"SIKKIM","INDECENT REPRESENTATION OF WOMEN (PROHIBITION) ACT ",0,0,0,0,0,0,0,0,0,0,0,0
"TAMIL NADU","INDECENT REPRESENTATION OF WOMEN (PROHIBITION) ACT ",7,40,0,19,28,12,40,0,22,18,10,8
"TRIPURA","INDECENT REPRESENTATION OF WOMEN (PROHIBITION) ACT ",0,0,0,0,0,0,0,0,0,0,0,0
"UTTAR PRADESH","INDECENT REPRESENTATION OF WOMEN (PROHIBITION) ACT ",1,0,1,0,0,6,6,0,3,3,3,0
"UTTARAKHAND","INDECENT REPRESENTATION OF WOMEN (PROHIBITION) ACT ",0,0,0,0,0,0,0,0,0,0,0,0
"WEST BENGAL","INDECENT REPRESENTATION OF WOMEN (PROHIBITION) ACT ",6,10,1,3,12,19,31,0,26,5,0,5
"TOTAL (STATES)","INDECENT REPRESENTATION OF WOMEN (PROHIBITION) ACT ",56,175,7,50,174,1397,1571,0,1366,205,108,97
"A & N ISLANDS","INDECENT REPRESENTATION OF WOMEN (PROHIBITION) ACT ",0,0,0,0,0,0,0,0,0,0,0,0
"CHANDIGARH","INDECENT REPRESENTATION OF WOMEN (PROHIBITION) ACT ",0,0,0,0,0,1,1,0,1,0,0,0
"D & N HAVELI","INDECENT REPRESENTATION OF WOMEN (PROHIBITION) ACT ",0,0,0,0,0,0,0,0,0,0,0,0
"DAMAN & DIU","INDECENT REPRESENTATION OF WOMEN (PROHIBITION) ACT ",0,0,0,0,0,0,0,0,0,0,0,0
"DELHI","INDECENT REPRESENTATION OF WOMEN (PROHIBITION) ACT ",1,0,0,1,0,6,6,0,6,0,0,0
"LAKSHADWEEP","INDECENT REPRESENTATION OF WOMEN (PROHIBITION) ACT ",0,0,0,0,0,1,1,0,0,1,0,1
"PUDUCHERRY","INDECENT REPRESENTATION OF WOMEN (PROHIBITION) ACT ",0,0,0,0,0,0,0,0,0,0,0,0
"TOTAL (UTs)","INDECENT REPRESENTATION OF WOMEN (PROHIBITION) ACT ",1,0,0,1,0,8,8,0,7,1,0,1
"TOTAL (ALL-INDIA)","INDECENT REPRESENTATION OF WOMEN (PROHIBITION) ACT ",57,175,7,51,174,1405,1579,0,1373,206,108,98
"ANDHRA PRADESH","DOWRY PROHIBITION ACT",1099,2780,25,1020,2834,2668,5502,537,3711,1254,81,1173
"ARUNACHAL PRADESH","DOWRY PROHIBITION ACT",0,0,0,0,0,0,0,0,0,0,0,0
"ASSAM","DOWRY PROHIBITION ACT",141,63,4,167,33,258,291,0,280,11,2,9
"BIHAR","DOWRY PROHIBITION ACT",2521,2778,33,2498,2768,12265,15033,344,13199,1490,313,1177
"CHHATTISGARH","DOWRY PROHIBITION ACT",0,40,0,0,40,66,106,0,86,20,10,10
"GOA","DOWRY PROHIBITION ACT",0,0,0,0,0,0,0,0,0,0,0,0
"GUJARAT","DOWRY PROHIBITION ACT",16,0,0,0,16,84,100,0,78,22,0,22
"HARYANA","DOWRY PROHIBITION ACT",2,8,0,0,10,63,73,0,43,30,17,13
"HIMACHAL PRADESH","DOWRY PROHIBITION ACT",0,0,0,0,0,46,46,0,46,0,0,0
"JAMMU & KASHMIR","DOWRY PROHIBITION ACT",0,1,0,0,1,22,23,0,23,0,0,0
"JHARKHAND","DOWRY PROHIBITION ACT",543,1689,0,866,1366,2444,3810,50,2721,1039,207,832
"KARNATAKA","DOWRY PROHIBITION ACT",406,2578,50,516,2418,5169,7587,67,6268,1252,65,1187
"KERALA","DOWRY PROHIBITION ACT",3,6,0,2,7,22,29,0,29,0,0,0
"MADHYA PRADESH","DOWRY PROHIBITION ACT",0,321,0,0,321,667,988,4,898,86,38,48
"MAHARASHTRA","DOWRY PROHIBITION ACT",9,106,0,17,98,959,1057,0,905,152,9,143
"MANIPUR","DOWRY PROHIBITION ACT",0,0,0,0,0,0,0,0,0,0,0,0
"MEGHALAYA","DOWRY PROHIBITION ACT",0,0,0,0,0,0,0,0,0,0,0,0
"MIZORAM","DOWRY PROHIBITION ACT",0,0,0,0,0,0,0,0,0,0,0,0
"NAGALAND","DOWRY PROHIBITION ACT",0,0,0,0,0,0,0,0,0,0,0,0
"ODISHA","DOWRY PROHIBITION ACT",186,2049,0,154,2081,7313,9394,0,7979,1415,171,1244
"PUNJAB","DOWRY PROHIBITION ACT",9,0,0,8,1,33,34,0,34,0,0,0
"RAJASTHAN","DOWRY PROHIBITION ACT",0,50,0,0,50,7,57,0,53,4,4,0
"SIKKIM","DOWRY PROHIBITION ACT",0,0,0,0,0,0,0,0,0,0,0,0
"TAMIL NADU","DOWRY PROHIBITION ACT",143,569,1,185,526,1405,1931,0,1300,631,386,245
"TRIPURA","DOWRY PROHIBITION ACT",0,0,0,0,0,3,3,0,0,3,0,3
"UTTAR PRADESH","DOWRY PROHIBITION ACT",59,2244,490,898,915,1857,2772,4,2391,377,216,161
"UTTARAKHAND","DOWRY PROHIBITION ACT",0,0,0,0,0,11,11,0,9,2,0,2
"WEST BENGAL","DOWRY PROHIBITION ACT",69,466,4,87,444,215,659,0,485,174,15,159
"TOTAL (STATES)","DOWRY PROHIBITION ACT",5206,15748,607,6418,13929,35577,49506,1006,40538,7962,1534,6428
"A & N ISLANDS","DOWRY PROHIBITION ACT",0,0,0,0,0,4,4,0,4,0,0,0
"CHANDIGARH","DOWRY PROHIBITION ACT",1,0,0,1,0,0,0,0,0,0,0,0
"D & N HAVELI","DOWRY PROHIBITION ACT",0,0,0,0,0,1,1,0,1,0,0,0
"DAMAN & DIU","DOWRY PROHIBITION ACT",0,0,0,0,0,0,0,0,0,0,0,0
"DELHI","DOWRY PROHIBITION ACT",4,11,0,12,3,101,104,0,96,8,7,1
"LAKSHADWEEP","DOWRY PROHIBITION ACT",0,0,0,0,0,0,0,0,0,0,0,0
"PUDUCHERRY","DOWRY PROHIBITION ACT",22,27,0,27,22,83,105,0,98,7,0,7
"TOTAL (UTs)","DOWRY PROHIBITION ACT",27,38,0,40,25,189,214,0,199,15,7,8
"TOTAL (ALL-INDIA)","DOWRY PROHIBITION ACT",5233,15786,607,6458,13954,35766,49720,1006,40737,7977,1541,6436
"ANDHRA PRADESH","TOTAL CRIMES",11292,39288,25,11364,39191,65398,104589,7164,70459,26966,3527,23439
"ARUNACHAL PRADESH","TOTAL CRIMES",123,202,42,153,130,1670,1800,14,1691,95,24,71
"ASSAM","TOTAL CRIMES",10244,12346,4139,10757,7694,19148,26842,297,20419,6126,637,5489
"BIHAR","TOTAL CRIMES",15499,20147,347,16017,19282,60345,79627,768,69741,9118,1317,7801
"CHHATTISGARH","TOTAL CRIMES",347,6594,0,375,6566,27395,33961,1210,27382,5369,1605,3764
"GOA","TOTAL CRIMES",149,286,13,295,127,679,806,2,737,67,7,60
"GUJARAT","TOTAL CRIMES",1486,23965,1,1925,23525,159072,182597,594,170125,11878,434,11444
"HARYANA","TOTAL CRIMES",1084,7264,0,919,7429,24779,32208,127,24325,7756,1266,6490
"HIMACHAL PRADESH","TOTAL CRIMES",264,1325,21,251,1317,6764,8081,263,6867,951,107,844
"JAMMU & KASHMIR","TOTAL CRIMES",55,5204,0,56,5203,24967,30170,933,24918,4319,338,3981
"JHARKHAND","TOTAL CRIMES",2516,6549,5,3340,5720,9288,15008,158,10554,4296,1152,3144
"KARNATAKA","TOTAL CRIMES",2615,16680,345,3101,15849,37375,53224,645,41480,11099,859,10240
"KERALA","TOTAL CRIMES",2520,13517,9,2841,13187,51867,65054,298,57078,7678,862,6816
"MADHYA PRADESH","TOTAL CRIMES",279,29247,0,292,29234,91132,120366,5179,96896,18291,5529,12762
"MAHARASHTRA","TOTAL CRIMES",11759,41048,104,13168,39535,289702,329237,3196,297880,28161,1047,27114
"MANIPUR","TOTAL CRIMES",255,202,182,247,28,165,193,1,190,2,0,2
"MEGHALAYA","TOTAL CRIMES",419,271,55,475,160,995,1155,0,1127,28,9,19
"MIZORAM","TOTAL CRIMES",21,215,0,51,185,186,371,0,217,154,118,36
"NAGALAND","TOTAL CRIMES",17,75,8,15,69,51,120,0,58,62,58,4
"ODISHA","TOTAL CRIMES",1618,17183,44,1615,17142,63156,80298,0,71122,9176,974,8202
"PUNJAB","TOTAL CRIMES",3570,5048,315,4864,3439,13996,17435,5,14645,2785,904,1881
"RAJASTHAN","TOTAL CRIMES",262,17095,0,270,17087,78777,95864,2822,81296,11746,4582,7164
"SIKKIM","TOTAL CRIMES",35,69,20,37,47,147,194,1,106,87,35,52
"TAMIL NADU","TOTAL CRIMES",5709,10913,317,6912,9393,21609,31002,2,23987,7013,2046,4967
"TRIPURA","TOTAL CRIMES",843,1946,253,448,2088,2731,4819,0,2659,2160,349,1811
"UTTAR PRADESH","TOTAL CRIMES",9439,77745,24523,18886,43775,115327,159102,2496,131222,25384,12971,12413
"UTTARAKHAND","TOTAL CRIMES",159,1420,11,225,1343,6082,7425,108,5982,1335,813,522
"WEST BENGAL","TOTAL CRIMES",9798,34023,2239,7888,33694,138697,172391,609,157445,14337,915,13422
"TOTAL (STATES)","TOTAL CRIMES",92377,389867,33018,106787,342439,1311500,1653939,26892,1410608,216439,42485,173954
"A & N ISLANDS","TOTAL CRIMES",68,73,0,68,73,693,766,0,739,27,5,22
"CHANDIGARH","TOTAL CRIMES",85,268,1,87,265,872,1137,0,928,209,38,171
"D & N HAVELI","TOTAL CRIMES",10,30,0,2,38,194,232,0,206,26,4,22
"DAMAN & DIU","TOTAL CRIMES",65,45,0,56,54,187,241,0,202,39,1,38
"DELHI","TOTAL CRIMES",1580,3981,146,2018,3397,28992,32389,0,28115,4274,1771,2503
"LAKSHADWEEP","TOTAL CRIMES",0,1,0,1,0,3,3,2,0,1,0,1
"PUDUCHERRY","TOTAL CRIMES",88,110,0,95,103,789,892,0,748,144,26,118
"TOTAL (UTs)","TOTAL CRIMES",1896,4508,147,2327,3930,31730,35660,2,30938,4720,1845,2875
"TOTAL (ALL-INDIA)","TOTAL CRIMES",94273,394375,33165,109114,346369,1343230,1689599,26894,1441546,221159,44330,176829
